# Types
# 0 Wall
# 1 Grass
# 2 Water
# 3 Rock
# 4 Mud

# format: H W 4neighborhood bidirectional
10 8 1 1

# format: type
0 0 0 0 0 0 0 0
0 1 0 1 1 1 1 0
0 1 0 1 1 1 0 0
0 1 4 2 2 1 0 0
0 1 4 2 2 2 2 0
0 3 4 0 0 0 0 0
0 3 3 3 3 3 3 0
0 3 0 3 3 3 3 0
0 3 0 3 3 3 3 0
0 0 0 0 0 0 0 0